........###
..##.#.###.
.##..###..#
##........#
#..#@#.#..#
#.##.###..#
..#..#....#
.##.##.#.##
.#......##.
.#.....##..
.#######..#