.......#...
...........
...@.......
...........
.....#.....
.@.........
...........
...#.......
...........
..........@