#####################
#...................#
#...................#
#..+++++++++++++++..#
#..+.............+..#
#..+.+++++++++++.+..#
#..+.+.........+.+..#
#..+.+.@.......+.+..#
#..+.+.........+.+..#
#..+.+.........+.+..#
#.........#.........#
#..+.+.........+.+..#
#..+.+.........+.+..#
#..+.+.........+.+..#
#..+.+.........+.+..#
#..+.+++++++++++.+..#
#..+.............+..#
#..+++++++++++++++..#
#...................#
#...................#
#####################