#####################
#...................#
#...+++.......+++...#
#..+.............+..#
#.+...............+.#
#.+...............+.#
#.+...............+.#
#......@..+.........#
#........+..........#
#.......+...........#
#......+..#.........#
#.......+...........#
#........+..........#
#.........+.........#
#.+...............+.#
#.+...............+.#
#.+...............+.#
#..+.............+..#
#...+++.......+++...#
#...................#
#####################