#####################
#.........+.........#
#...................#
#....++.......++....#
#...................#
#....+..+..+..+..+..#
#...+..+..+..+..+...#
#..+..+@.+..+..+....#
#.+..+..+..+..+.....#
#..+..+..+..+..+....#
#...+..+..+..+..+...#
#....+..+..+..+..+..#
#...................#
#....+...+...+...+..#
#...+.+.+.+.+.+.+...#
#..+...+...+...+....#
#...................#
#....++.......++....#
#...................#
#.........+.........#
#####################