#####################
#.........+.........#
#.........+.........#
#.........+.........#
#....@....+.........#
#.........+.........#
#...................#
#...................#
#...................#
#...................#
#+++++....#....+++++#
#...................#
#...................#
#...................#
#...................#
#.........+.........#
#.........+.........#
#.........+.........#
#.........+.........#
#.........+.........#
#####################