#####################
#.........+.........#
#...................#
#.....+.......+.....#
#....+++.....+++....#
#...................#
#...................#
#......@............#
#...+...........+...#
#..+.+.........+.+..#
#...................#
#...................#
#........+.+........#
#.........+.........#
#...................#
#...................#
#....+++.....+++....#
#.....+.......+.....#
#...................#
#.........+.........#
#####################