#####################
#...................#
#.....+++++++++.....#
#.....+.......+.....#
#.....+.......+.....#
#.B.................#
#.........+.........#
#........+.+........#
#.........+.........#
#...+...@.......+...#
#..+.+.........+.+..#
#...+...........+...#
#.......B.+.........#
#........+.+........#
#.........+.........#
#...................#
#.....+.......+.....#
#.....+.......+.....#
#.....+++++++++.....#
#...................#
#####################