#####################
#...................#
#.....+++++++++.....#
#.....+.......+.....#
#.....+.......+.....#
#...................#
#.........+.........#
#........+.+........#
#.........+.........#
#...+...@.......+...#
#..+.+.........+.+..#
#...+...........+...#
#.........+.........#
#........+.+........#
#.........+.........#
#...................#
#.....+.......+.....#
#.....+.......+.....#
#.....+++++++++.....#
#...................#
#####################