#####################
#...................#
#...................#
#..+++++++++++++++..#
#..+++++++++++++++..#
#..++...........++..#
#..++...........++..#
#..++..@........++..#
#..++...........++..#
#..++.....+.....++..#
#........+#+........#
#..++.....+.....++..#
#..++...........++..#
#..++...........++..#
#..++...........++..#
#..++...........++..#
#..+++++++++++++++..#
#..+++++++++++++++..#
#...................#
#...................#
#####################