#####################
#.........+..Q......#
#...................#
#.....+.......+.....#
#....+++.....+++....#
#...................#
#...................#
#...................#
#...+...........+...#
#..+.+..@......+.+..#
#...................#
#...................#
#........+.+........#
#.........+.........#
#..Q................#
#...................#
#....+++.....+++....#
#.....+.......+.Q...#
#...................#
#.........+.........#
#####################